9x9 4,4 1
000010000
000010000
000010000
000000000
111000111
000000000
000010000
000010000
000010000
