19x5 9,2 3
0000010000000100000
00#0010010100100#00
00#00X0010100X00#00
00#0010010100100#00
0000010000000100000
