9x9 4,4 2
#0000000#
000000000
001#X#100
00#000#00
00X000X00
00#000#00
001#X#100
000000000
#0000000#
